A       ##
# ##### ##
# #  ## ##
# ## ## ##
# ##    ##
# ########
# ########
#       ##
####### ##
#######B##