A	                          #       ##
########## ######### ############## ### # ##
         # ##     ## #              ### # ##
 #### ## # ## ###    ## ########### ### # ##
 #### #### ## ### ##### ##          ### # ##
   ##      ## ###       ## ############ # ##
 ##########   ###   ###### ##          #  #
   ## ##### ######      ## ## #### #### #
 # ##    ## ####### ######   ## #### ## ## #
## ##### ## #### ##    ### ##### #### ## # #
     ### ##      ##### ### ########## ## # #
## # ### ####### ##### ###      #####    # #
 #######               ######## ########## #
         ######################          B###

