A     ####
### ######
    ######
###     ##
#   ######
###     ##
####### ##
#       ##
### ######
#B     ###